1111111111111111111111111
1000000000000000000000001
1011101111111111111011101
1000100000001000000010001
1010101010000000101010101
1010101000111110001010101
1000001110100010111000001
1010101000111110001010101
1010101010000000101010101
1000100000001000000010001
1011101111111111111011101
1000000000000000000000001
1111111111111111111111111