1111111111111111111111111111111111111
1000000010000000001000000000100000001
1010111010111111101011111110101110101
1010000010000000001000000000100000101
1010111010111111101011111110101110101
1010100000111111101011111110000010101
1000001010000011100011100000101000001
1010111010111000000000001110101110101
1010000010001101111111011000100000101
1011101010100101111111010010101011101
1000001010110100000000010110101000001
1111101000000101110111010000001011111
0000001111110101000001010111111000000
1111101000000101111111010000001011111
1000001010110100000000010110101000001
1011101010100101111111010010101011101
1010000010001101111111011000100000101
1010111010111000000000001110101110101
1000001010000011100011100000101000001
1010100000111111101011111110000010101
1010111010111111101011111110101110101
1010000010000000001000000000100000101
1010111010111111101011111110101110101
1000000010000000001000000000100000001
1111111111111111111111111111111111111
