210001010210121020121022010202021121011112000202020100120121212122102021100
111001100201201120102200002111121100021120002210020002110212010022220002010
202122020010000010211010011001202110012210122202201122020100111012211021022
211201010111211100212212120121110010210202202221102222012210102020110122010
220221221202101002110212211022100021012101110202120202002002210021120011220
200021212002221202210212120201001120220221210221202212210221210101122002101
120220012222222101112121002122200100120121222220121210222121220222221202000
102011010011101102111111021021011002122201100222102102210010012110021002122
001010220102112201011222222202201202101020220211111000110101121012000120111
212200120211112201102100010211211110201012122001020200022011101212002220001
101122121011112020000021121102110022001000100221210000212022001201220002022
020020020201012200001010021212012220002121022122222021110220121110101112212
022110102002102110002111022110010001011021012121120021211122101221120201122
120201001201121200020222111212221010121001212100121011120022120220222001121
212210001012211000001010222122021001011002001102102001121002122200010010210
002210102120011222221222212002111011212120111201022020120110022010102010021
222000210201210000020210222121122120110100212022101002222121121212221011201
121102120122012020010220020200101022221022120222010211111221000110011121110
221202002020100011020221121220210212001022121121000110221222220210211201210
122022212110120012021201121001001202202000202110020022111121111222011112001
002021002110012202222222011110200022100220100112202112100012201111202202001
222201201201011112102010122121121022222020011111201211110100222101200020112
002200200201202002210201100211210010102122002022110222011202221012010102201
020121021102121111211201120220112200221002122020120022110002101120012222011
120011201222012020221101201101000100020000011212110220022120010102100201220
102212101222111112220210000200111112001112211222011211221121210010012012002
102211211022121000122102010100211012011022221121110200101210111101201100121
100112101110021222012112001020111100201101010011102212000200201111122002112
112011002101022101110021022202201110121212211121121201220111000001012212222
012200121202211220120210210002002120102220011022020021210121100210210210101
211021121221212211210020100001010201021111101111101110022021110222011002010
210211211110011012202221012022001110010222212220121020022112021012200010111
110212010120202020211110022202112101200212121021002200201120101202212100202
220000002201001120222110020211222211210000212012010212120021022202011120122
001211202200122120212122021110000221120102100212220202021202021221002012002
220111220110011201102220202111221112212111122201020001221020201110110111102
010010110022110012001220111120201020012200111201222100000200012011001220010
222010010122101212210102122221121001022012000012000100220210102121210211001
002212212101111100210110110212101012200001021212112122202100100201012202012
220121100220201120100220102222120002000020010001220002021002022210100001112